Storage Room
13 13
#############1
##   e  # e #2
#  #      # #3
#   #       #4
#           #5
#   e# #    #6
#  #  p     #7
#    # #   ##8
#           #9
#   #       #10
#        #  #11
##e        ##12
#############13
